#List of names of species to include in the zooproject phylogeny
#study.  These may be extracted with PrintSpeciesIds.pl
#And species identifier.
#Format:
#NISC Name<tab>truncated namee<tab>species id<br>
#
Human	human	1
Chimpanzee	Chimpanzee	2
Gorilla (lowland)	Gorilla	3
Orangutan	Orangutan	4
Baboon (olive)	Baboon	5
Gibbon (northern white-cheeked)	Gibbon	6
Monkey (rhesus)	 Rhesus		7
Monkey (colobus)	Colobus	8
Monkey (African green)		GreenMonkey	9
Marmoset (white-tufted-ear)	Marmoset	10
Monkey (black-handed spider)	SpiderMonkey	11
Monkey (Bolivian squirrel)	BolivianMonkey	12
Monkey (owl)	OwlMonkey	13
Dusky titi	 Dusky	14
Lemur (ring-tailed)	RingTailedLemur	15
Black lemur	BlackLemur	16
Lemur (gray mouse)	   GrayMouseLemur	17
Galago (small-eared)	   Galago	18
Rabbit	Rabbit	19
Squirrel (13-lined ground)	Squirrel	20
Guinea Pig	GunieaPig	21
Mouse (house)	Mouse	22
Rat (Norway)	Rat	23
Pig	Pig	24
Cow	Cow	25
Sheep	Sheep	26
Muntjak (Indian)	IndianMuntjak	27
Chinese muntjac	ChineseMuntjak	28
Horse	Horse	29
Cat	Cat	30
Leopard (clouded)	Leopard	31
Dog	Dog	32
Ferret (European)	Ferret	33
Bat (greater horseshoe)	HorsehoeBat	34
Bat (little brown)	BrownBat	35
Bat (Seba's short-tailed)	SebaBat	37
Hedgehog (middle-African)	Hedgehog	38
Shrew (European)	Shrew	39
Armadillo (nine-banded)	Armadillo	40
Elephant (African)	Elephant	41
Tenrec (lesser hedgehog)	Tenrec	42
Opossum (North American)	Opossum	43
Opossum (gray short-tailed)	GrayOpossum	44
Wallaby (tammar)	Wallaby	45
Platypus	Platypus	46
Echidna (Australian)	Echidna	47
Dunnart (stripe-faced)	Dunnart 67
